....................
....................
....................
....................
....................
....................
....................
...................M
............########
P..................M
####################
....................
....................
...................M
####################
....................
....................
....................
....................
....................
