....................
....................
....................
....................
....................
....................
....................
....................
....................
....................
....................
....................
....................
....................
P...................
...........B..B.....
....##..............
....B...............
####################
...#................
