....................
....................
....................
....................
....................
....................
....................
....................
....................
....................
....................
....................
....................
....................
P...................
....................
....................
....B...B..........M
#####...############
....................
