....................
....................
....................
....................
....................
....................
....................
....................
....................
.........T..########
.......T..##........
........##..........
......##............
....##..............
P.##................
##..................
....................
....................
....................
....................
