....................
.SSS.C...C.MMM......
.S...CC..C.M..M.....
.SS..C.C.C.M..M.....
.S...C..CC.M..M.....
.SSS.C...C.MMM......
....................
....................
....................
....................
....................
....................
....................
....................
....................
BBBBBBBBBBBBBBBBBBBB
P...................
####################
....................
....................
